1111111111111111111111111111111111111111111111111
1000000000000000000000000000000000000000000000001
1000E00000010000000000000000000000000000000000001
100000P000010000000000000000000000000000000000001
1000000000010000000000000C00000000000000000000001
1000000000010000000000000000000000000000000000001
1000000000010000000000000000000000000000000000001
1000010000010000000000000000000000000000000000001
1000000000010000000000000000000000000000000000001
1000000000010000000000000000000000000000000000001
1000000000010000000000000000000000000000000000001
1000000000010000000000000000000000000000000000001
1000000000010000000000000000000000000000000000001
1000000000010000000000000000000000000000000000001
1000000000010000000000000000000000000000000000001
1000010000010000000000000000000000000000000000001
1000000000010000000000000000000000000000000000001
1000000000010000000000000000000000000000000000001
1000000000010000000000000000000000000000000000001
1000000000010000000000000000000000000000000000001
10000000000100000EEEEEEEEEEEEEEEEE000000000000001
1000000000010000000000000000000000000000000000001
1000000000010000000000000000000000000000000000001
1000000000010000000000000000000000000000000000001
1000000000010000000000000000000000000000000000001
1000010000010010000000000000000000000000000000001
1000000000010000000000000000000000000000000000001
1000000000010000000000000000000000000000000000001
1000000000010000000000000000000000000000000000001
1000000000010000000000000000000000000000000000001
1000000000010000000000000000000000000000000000001
1000000000010000000000000000000000000000000000001
1000000000010000000000000000000000000000000000001
1000000000010000000000000000000000000000000000001
1000000000010000000000000000000000000000000000001
1000010000010010000000000000000000000000000000001
1000000000010000000000000000000000000000000000001
1000000000010000000000000000000000000000000000001
1000000000010000000000000000000000000000000000001
1000000000010000000000000000000000000000000000001
1111111111111111111111111111111111111111111111111