1111111111111111111111111111111
1000000000000000000000000000001
1000E00000010000000000000000001
100000P000010000000000000000001
1000000000010000000000000000001
1000000000010000000000000000001
1000000000010000000000000000001
10000C00000100C0000000000000001
1000000000010000000000000000001
1000000000010000000000000000001
1000000000010000000000000000001
1000000000010000000000000000001
1000000000010000000000000000001
1000000000010000000000000000001
1000000000010000000000000000001
10000C00000100C0000000000000001
1000000000010000000000000000001
1000000000010000000000000000001
1000000000010000000000000000001
1000000000010000000000000000001
1000000000010000000000000000001
1000000000010000000000000000001
1000000000010000000000000000001
1000000000010000000000000000001
1000000000010000000000000000001
10000C00000100C0000000000000001
1000000000010000000000000000001
1000000000010000000000000000001
1000000000010000000000000000001
1000000000010000000000000000001
1000000000010000000000000000001
1000000000010000000000000000001
1000000000010000000000000000001
1000000000010000000000000000001
1000000000010000000000000000001
10000C00000100C0000000000000001
1000000000010000000000000000001
1000000000010000000000000000001
1000000000010000000000000000001
1000000000010000000000000000001
1111111111111111111111111111111